1111111111
1011111011
1100010111
1000100011
1100001111
1010010001
1101001011
1011111001
1011000101
1111111111